{
 "기": "91",
 "억": "92",
 "의": "93",
 "상": "94",
 "은": "9B",
 "당": "9D",
 "신": "9E",
 "을": "A5",
 "합": "A6",
 "니": "A8",
 "다": "A9"
}